
        [coherence.plugins.backend.media_server]
        FSStore = coherence.backends.fs_storage:FSStore
        MediaStore = coherence.backends.mediadb_storage:MediaStore
        ElisaMediaStore = coherence.backends.elisa_storage:ElisaMediaStore
        FlickrStore = coherence.backends.flickr_storage:FlickrStore
        AxisCamStore = coherence.backends.axiscam_storage:AxisCamStore
        BuzztardStore = coherence.backends.buzztard_control:BuzztardStore
        IRadioStore = coherence.backends.iradio_storage:IRadioStore
        LastFMStore = coherence.backends.lastfm_storage:LastFMStore
        AmpacheStore = coherence.backends.ampache_storage:AmpacheStore
        TrackerStore = coherence.backends.tracker_storage:TrackerStore
        DVBDStore = coherence.backends.dvbd_storage:DVBDStore
        AppleTrailersStore = coherence.backends.appletrailers_storage:AppleTrailersStore
        LolcatsStore = coherence.backends.lolcats_storage:LolcatsStore
        TEDStore = coherence.backends.ted_storage:TEDStore
        BBCStore = coherence.backends.bbc_storage:BBCStore
        SWR3Store = coherence.backends.swr3_storage:SWR3Store
        Gallery2Store = coherence.backends.gallery2_storage:Gallery2Store
        YouTubeStore = coherence.backends.youtube_storage:YouTubeStore
        MiroGuideStore = coherence.backends.miroguide_storage:MiroGuideStore
        ITVStore = coherence.backends.itv_storage:ITVStore
        PicasaStore = coherence.backends.picasa_storage:PicasaStore
        TestStore = coherence.backends.test_storage:TestStore
        PlaylistStore = coherence.backends.playlist_storage:PlaylistStore
        YamjStore = coherence.backends.yamj_storage:YamjStore
        BansheeStore = coherence.backends.banshee_storage:BansheeStore
        FeedStore = coherence.backends.feed_storage:FeedStore
        RadiotimeStore = coherence.backends.radiotime_storage:RadiotimeStore
        AudioCDStore = coherence.backends.audiocd_storage:AudioCDStore
        
        [coherence.plugins.backend.media_renderer]
        ElisaPlayer = coherence.backends.elisa_renderer:ElisaPlayer
        GStreamerPlayer = coherence.backends.gstreamer_renderer:GStreamerPlayer
        BuzztardPlayer = coherence.backends.buzztard_control:BuzztardPlayer

        [coherence.plugins.backend.binary_light]
        SimpleLight = coherence.backends.light:SimpleLight

        [coherence.plugins.backend.dimmable_light]
        BetterLight = coherence.backends.light:BetterLight
    